# vim: ts=60 sw=0 noet cms=#\ %s
brenoprata10/start/nvim-highlight-colors	git@github.com:brenoprata10/nvim-highlight-colors.git
dgagn/start/diagflow.nvim	git@github.com:dgagn/diagflow.nvim.git
DNLHC/start/glance.nvim	git@github.com:DNLHC/glance.nvim.git
echasnovski/start/mini.nvim	git@github.com:echasnovski/mini.nvim.git
folke/opt/neodev.nvim	git@github.com:folke/neodev.nvim.git
folke/opt/twilight.nvim	git@github.com:folke/twilight.nvim.git
folke/start/flash.nvim	git@github.com:folke/flash.nvim.git
folke/start/trouble.nvim	git@github.com:folke/trouble.nvim.git
github/start/copilot.vim	git@github.com:github/copilot.vim.git
j-hui/start/fidget.nvim	git@github.com:j-hui/fidget.nvim.git
# lewis6991/start/gitsigns.nvim	git@github.com:lewis6991/gitsigns.nvim.git
mfussenegger/start/nvim-ansible	git@github.com:mfussenegger/nvim-ansible.git
mfussenegger/start/nvim-lint	git@github.com:mfussenegger/nvim-lint.git
nvim-lua/start/plenary.nvim	git@github.com:nvim-lua/plenary.nvim.git
nvim-telescope/start/telescope.nvim	git@github.com:nvim-telescope/telescope.nvim.git
nvim-tree/start/nvim-web-devicons	git@github.com:nvim-tree/nvim-web-devicons.git
nvim-treesitter/start/nvim-treesitter	git@github.com:nvim-treesitter/nvim-treesitter.git
nvim-treesitter/start/nvim-treesitter-context	git@github.com:nvim-treesitter/nvim-treesitter-context.git
nvim-treesitter/start/nvim-treesitter-textobjects	git@github.com:nvim-treesitter/nvim-treesitter-textobjects.git
nvim-treesitter/start/playground	git@github.com:nvim-treesitter/playground.git
nvimdev/start/epo.nvim	git@github.com:nvimdev/epo.nvim.git
romainl/start/vim-qf	git@github.com:romainl/vim-qf.git
stevearc/start/conform.nvim	git@github.com:stevearc/conform.nvim.git
stevearc/start/oil.nvim	git@github.com:stevearc/oil.nvim.git
tpope/start/vim-sleuth	git@github.com:tpope/vim-sleuth.git
tpope/start/vim-vinegar	git@github.com:tpope/vim-vinegar.git

# Colorschemes
rktjmp/opt/lush.nvim	git@github.com:rktjmp/lush.nvim.git
rose-pine/start/neovim	git@github.com:rose-pine/neovim.git
catppuccin/start/nvim	git@github.com:catppuccin/nvim.git
folke/start/tokyonight.nvim	git@github.com:folke/tokyonight.nvim.git
mcchrish/start/zenbones.nvim	git@github.com:mcchrish/zenbones.nvim.git
rebelot/start/kanagawa.nvim	git@github.com:rebelot/kanagawa.nvim.git
sainnhe/start/everforest	git@github.com:sainnhe/everforest.git
sainnhe/start/gruvbox-material	git@github.com:sainnhe/gruvbox-material.git
